가내(하다): 갈다
가이다: 가까이하다, 접근하다
간디: 그런데
강구: 개미
객쩍다: 터무니없다, 싱겁다
개안타/갠안타: 괜찮다
걸다: 진하다, 맛있다
고매: 고맙다
고무마: 고구마
골마리: 끄트머리, 끝
곰팡내: 곰팡이 냄새
공구리: 콘크리트
구디: 구덩이
구무락지: 작은 구덩이
구시:  구유
군디: 군데
궁디: 엉덩이
궁하다: 배고프다, 궁핍하다
그라마/그라마이: 그렇다면, 그러면
그라모: 그러면
그라재이: 그렇게 해라 
그렇지야: 그렇지
까끌하다: 까끌까끌하다
깔딱고개: 가파른 고개
깡그리: 모조리, 전부 다
꼽등이: 곱등이
꼬라지: 모양새, 꼴 
꼬방이: 방의 구석진 곳
꼽배기: 곱빼기
꾸매다: 꿰매다
끄네끼: 끈
끌비: 겨울을 나기 위해 쌓아둔 땔감
내나: 역시, 그대로
내삐리다: 내던지다, 버리다
넘아지다: 넘어지다
농사지이: 농사짓다
느자구 없다: 예의 없다, 버릇없다
니끼하다: 느끼하다
다구지다: 다부지다, 단단하다
단디: 단단히, 야무지게, 똑바로
달기다: 새다, 흐르다
대꼬리: 대나무 줄기
덤비다: 덤비다
데따/대따: 매우, 아주 
도구락: 도시락
돌구다: 돌리다, 굴리다
동티나다: 재앙이 생기다
두러지다: 두드러지다
두루막이: 두루마기 
등때기: 등
따개비: 쇠못이나 철사를 이용해 만든 도구
뜩하다: 뚝 떨어지다
마카: 전부 다
마이: 많이
만지다: 만지다 
맨치로/맨치로로: ~처럼, ~만큼 
매물다: 맵다 
매매: 몹시, 아주
메지: 메주
모리다: 모르다
모지라다: 모자라다
묵다: 먹다
문디: 못난이
물팍: 무릎
바래다: 바래다 
반디: 반딧불이
발리: 빨리
밭때기: 밭 
밤새미: 밤샘
빼다지: 서랍
빼묵다: 빼먹다
복상: 배 타는 노인
뿌리다: 버리다 
삐비: 띠
새비다: 훔치다 
서분하다: 서운하다
성가시다: 귀찮다, 성가시다
성님: 형님
소태: 쓰다 
시부모: 시어머니와 시아버지
식겁하다: 깜짝 놀라다
씸싸다: 싸다, 감싸다
아재: 아저씨
아지매: 아주머니
아재비: 아저씨 
얼라: 아이, 아기
여물: 소나 말에게 먹이는 사료
옴팡지다: 엄청나다
우예: 어떻게
울매나: 얼마나
자빠지다: 넘어지다
작대기: 막대기
쪼매: 조금
아리다: 아프다
파이다: 별로다
배때기: 배
가시개: 가위